13
13
1111111111111
1111111111111
1111111111111
1111111111111
1111110011111
1101100010111
1100001000111
1110111111111
1111111111111
1111111111111
1111111111111
1111111111111
1111111111111
