1111111111
1111111111
1100111011
1100110011
1110111011
1110011011
1111000011
1111111111
1111111111
1111111111
