111111111111111
111111111011011
111111011111111
100111011110111
101111001100011
101110111111011
001110111111011
011111111110011
011111111111111
011001000111111
111111011111111
111110011110111
111111110011111
111100011111111
111111111111111
