11111111111001111111
11111111111110001111
11111111111111110111
11111000001111111111
11111111101111111111
11111111000111111111
11110000110111111101
10001111111111111101
10111111111011111101
11111111111011111011
11110000010011111011
11111111110111110111
11111011101111101111
11100011111111001111
11110111111111111111
11100111111111111111
11001100000111111111
10011111111000011111
10111111111111001111
11111111111111111111
