1111111111111111111111111
1111111111111111111111111
1111111000000000011111111
1111111111111111010000111
1001111111111000001111111
1110011111110011111111111
1111101111101111111111101
1111111110011111110011001
1111111001111111111011111
1111100011111110000101111
1111100111111111110101111
1111101111111111110101111
1111111100000011110100111
1111011111111111110110111
1110011111111111110111111
1110111111111111101111111
1100111111111111101111110
1111111111111111011111101
1110000000001110111111101
1111111111110001111111001
1111111111111011111111011
1111111000111111111110011
1111111110100000111111111
1111111111111111111111111
1111111111111111111111111
